%%%%%%%%%%%%%%%%%%%%%%%%%%%%%%%%%%%%%
%                                   %
%                                   %
%                                   %
%               %%%%                %
%               %                   %
%               %                   %
%                                   %
%               %                   %
%               %                   %
%                                   %
%                                   %
%               %%                  %
%               %                   %
%.              %              P    %
%%%%%%%%%%%%%%%%%%%%%%%%%%%%%%%%%%%%%
