%%%%%%%%%%%%%%%%%%%%%%%%%%%%%%%%%%%%%
%                                   %
%                                   %
%                                   %
%               %%%%                %
%               %                   %
%               %                   %
%                                   %
%               %                   %
%               %                   %
%                                   %
%      %%%%%%% %                    %
%      %       %%%%%%%%%%%%%%%%%%%  %
%      % %%%%%%%     %              %
%.     %         %              P   %
%%%%%%%%%%%%%%%%%%%%%%%%%%%%%%%%%%%%%
